#############
#..#........#
#....#.##...#
#.....####..#
#...#..###..#
#....#..##..#
#.....@..#..#
###...#.....#
#....####..##
#.#.....#..##
#...#...#...#
#.#..#......#
#############

Glyphs
@:player:
#:wall:
.:floor:
x:enemy:name = skeleton, description = a mess., damage = 1
X:zombie:

Triggers