                                                
                                                
                                                
                                                
                                                
                                                
                                                
      #                                 #        
      #                                 #        
      #                                 #        
      #      #                    #     #        
      #     ###                  ###    #        
      #      #                    #     #        
      #                                 #        
      #                                 #        
      #                                 #        
      #      #                    #     #        
      #     ###                  ###    #        
      #      #                    #     #        
      #                                 #        
      #                                 #        
      #                                 #        
      #      #                    #     #        
      #     ###                  ###    #        
      #      #                    #     #        
      #                              ;  #        
      #                               ' #        
      #                                 #        
      #      #                    #     #        
      #     ###                  ###    #        
      ##     #                    #    ##       
       ##                             ##       
        ##                           ##         
         ##     ^---^-----^---^     ##         
          ##    -,,,,,,&,,,,,,-    ##          
          ###########################           